WE textures/purplestone.xpm
NO textures/bookshelf.xpm
EA textures/mossy.xpm

F 0,0,0
C 255,255

SO textures/redbrick.xpm

1111111111111111111
1000000000000000001
1000000000000000001
1000000N00000000001
1111111111111111111


