WE textures/purplestone.xpm

EA textures/purplestone.xpm

NO textures/purplestone.xpm

F 0, 0, 0
C 255,255,255

SO textures/redbrick.xpm


111111
100001
100001
100001
1000011111111111111
1000000000000000001
1000000000000000001
1000000N00000000001
1111111111111111111

