WE textures/purplestone.xpm
EA textures/purplestone.xpm
NO textures/purplestone.xpm

F 0,0,255
C 255,255,255

SO textures/redbrick.xpm


111111111111111
100001
100001
100S01
100001
100001
100001
100001
100001111111111
100000000000001
100000000000001
100000000000001
111111111111111
