1111111111111111111
1000000000000000001
1000000000000000001
1000E00000000000001
1000000000001111001
1000000000001001001
1000000000001001001
1000000000000000011
1000000000000000001
1111111111111111111
