
F      		255, 255, 25


	WE     textures/purplestone.xpm   	
EA textures/purplestone.xpm     

      				
   
NO       textures/purplestone.xpm 
     SO textures/redbrick.xpm
  



C     255, 255, 	200

11111111
10000001
10000001
1N00011111111111111
1000000000000000001
10000000  000000001
10000 0000000000001
1111111111111111111
1        
1










